M##XXXXX#X##XXX
#X#####X#XX#X##
##XX#X###X####X
X###XXXX###XXXX
###X#####XXX##X
XX#XXXX#X####XX
###XXX####XXXXX
#X###XX#X#X###X
#XX#X###X###XXX
XXX##XXXX#XXXXX
XXX#XX#X##XX##X
X######X#XX##XX
##XX##X#####XXX
X#XXX#XX#XX#XXX
X####XXX##X###A