M#X##XX##X###X#
##XX###########
###X#XXXX#X###X
#X#X#X##X#XXX##
#X#X#X##X#X####
#X###XX###X#XXX
#XXXXX##X#X#X#A
#X#####XX#X#X##
#X########X#X#X
#X##XXXXXXX#X##
#X##X#X###X####
#X##X#X#X#X##XX
#X##X#X#X#X#X#X
#X#XX#X#X#X####
########X####X#